#####################
#         @         #
#         A         #
#                   #
#                   #
#         a         #
#                   #
#                   #
#####################