########################################################
#                                                      #
#                                                      #
#                                                      #
#               ############                           #
#               #          #      @      #             #
#               #    B     #             #             #
#               #          #             #             #
#               #          ##########################  #
#      A        #          #             #          #  #
#               #          #             #    b     #  #
#               #          #      a      #          #  #
#################          #             #          #  #
#                          #             #          #  #
#                          #             #          #  #
#                          #             #          #  #
#               ############             #   ########  #
#                                                      #
#                                                      #
#                                                      #
#                                                      #
#                                                      #
#                                                      #
#                                                      #
########################################################

